5
2
6
6
67
MMMMMMMMMMMMMMMMMMMMMMMMMMMMMMMMMMMMMMMMMM
MEEDEFEEEEEMEEEEEEEEEFMEFEFEFEFEMEEEEEEEDM
MEEEEFEEEEEMEEEEEFEEEFMFEFEFEFEFMEEEEEEDEM
MDDEMFMEDEEMEEEEFDEEEFMEFEFEFEFEMEDEEEDEEM
MEDEMFMEEEEMEEEFDDEEEFF EFEFEFEFMEEDEEEEEM
MEEEMRMEEEEMEEFDDEEEEFMEFEFEFEFEMEEEEEEEEM
MEDEM EEEDEMEEDDEEEEEEMFEFEFEFEF EEEEEEEEM
MDEEM EDEEEMEEDEEEEDEEMEFEFEFEFEMEEEDEEEEM
MEEDM EEDEEMEEEEEEEEDEMFDFEFEFDFMDEEEEFFEM
MEEDM EEEEEMEDEEFEEEEEMEFDFDFEFEMEEEEFFFFM
MMMMMEMMMMMMMMMMFMMMMMMMMMMMMMMMMMMMMMMEMM
MEEEE EEEEEMEEEEFEEEEEMFFFDEEEE FFFFFEEEEM
MEEEE EEEFEMEEEEEEEEEEMFFDEEEED MFFFEEEEEM
MEEEE EEFDEMEEFE EEEEEMFDEEEEEE MFFEEEEEEM
MEDEE EFDEEMEDDE EDEEEMDEEEEEDE MFEEEEEDEM
MEDEE FDEEEMEEDE EEDEEMEEEDEEEE MEEEDEEEEM
MEDEE EEEEEMEEEE EEDDEMEEEEEEEE MEEEEEEEEM
MEEED EEEEFF EEE EEEEEMEEEEEEEE MEEEEEDEEM
MDEEF FEDEEM EEE EEEEEMFFEEEEEE MEDDEEEEEM
MEEDFDFDEEEM     EDEEEMDFFEEEEE MEEEEEEEEM
MMMMMMMMMMMMMMMMMMMMMMMMMMMMMMMMMMMMMMMMMM
75
