12
2
20
18
39
MMMMMMMMMMMMMMMMMMMMMMMMMMMMMMMMMMMMMMMMMM
MEEEEEEEEE FEEEEEEEEEEDEEEEEEEEEEEFEEEEEEM
MEEDEEEEEE FEEEEEEEEEEEEEEEEEEEEEEFEEEEEEM
MEEEEEEEEE FEEEEEEEEEEEEEEMMMMMMMMEEEEEEEM
MEEEEEDEEE FEEEDDEEEEEEEEEMEEEDEEEMEEEEEEM
MMMMMEEDEE FEEEEEEDEEEEEEEMFFFEEDEMEEEEEEM
MDMDMEEDEE FEEEEEDDEEEEEEEMDDFEDEEMEEEEEEM
MDMFMEEEEE FEEEEEEEEEEEEEEMMMMMMMMFEEEEEEM
MEMFMEEEEE FEEEEEEEEEEEEEEEEEEEEEEFEEEEEEM
MEMFMEEEDE FEEEEEEEEEDEEEEEEEEEEEEFEEEEEEM
M MFMEEDEE FEEEEEEEEEEEEEEEEEEEEEEEEEEEEEM
MMFFMEDEEE FEEEEEEEEEEEEEEEEEEEEEEEEEEEEEM
MEFDMEEEEE FMEMEEEEEEEEEEEEEDEEEEEEEEEEEEM
MEMEMEEEEE FMEMEEEEEEEEEEEEEEEEEEEEEEEEEEM
MDMEMEEEEE FMEMEEDEEEEFEEEEEEEEEEEEDEEEEEM
MDMEMEEEEEMFMEMEDEEEEEFEEEEEEEEEEEDEEEEEEM
MEMEMMMMEEMFMEMEDMEEEMFMMMMMEEEEEEDEEEEEEM
MEMEM FEEEMFMEMFFMMMMMFMEEEMEEEEEEEEEEDEEM
MEMEMFMMMMMFMEMFFMDDEEEEEDEMMMEEEEEEEEEEEM
MEEEEEEEEEEEEEEEERMMMEMMDDEEDMEEEEEEEEEEEM
MMMMMMMMMMMMMMMMMMMMMMMMMMMMMMMMMMMMMMMMMM
200
