10
3
18
12
66
MMMMMMMMMMMMMMMMMMMMMMMMMMMMMMMMMMMMMMMMMM
MEEEEEEEEEEEEEEEEEEEEEEEEEEDEEEEEEEEEEEEEM
MEEDEEEDDDEDEDEDDDEDEEEEEEDDEEEEEEEEEEEEEM
MEEDEEEDEEEDEDEDEEEDEEEEEDEDEEEEEEEEDFEEEM
MEEDEEEDDEEDEDEDDEEDEEEEEEEDEEEEEEEEFEEEEM
MEEDEEEDEEEEDEEDEEEDEEEEEEEDEEEEEEEEEEEEEM
MEEDDDEDDDEEDEEDDDEDDDEEEEEDEEEEEEE EEEEEM
MEEEEEEEEEEEEEEEEEEEEEEEEDDDDDEEEEEEEEEEEM
MEEEEEEEEEEEEEEEEEEEEEEEEEEEEEEEEEEEEDEEEM
MEEEEEEEEEEEEEEEEEEEEEEEEEEEEEEEEEEEEEEEEM
MEEEEEEEEEEEEEEEEEEEEEEEEEEEEEEEEEDEEEEEEM
MMMMMMMMMMMMMMMMEEEEEEEEEFEEEEEEEEEEEEEEEM
MEEEEEEEEDFEEEEMEEEEEEEEFFFEEEEEEEEEEEEEEM
MEMMMMEEEDDEEEEMEEEEEEEFEFEFEEEEEEEFFEEEEM
MEMEFFFEEE EEEEMEEEEEEEEEFEEEEEEEEFDDEEEEM
MEMEEEEEE  EEMMMEEEEEEEEEFEEEEEEE MDFEEEEM
MEMEEEEEEEEEEMEF  EEEEEEEFEEEEEEE DDEEEEEM
MEMEEEEEEEEREMEM EEEEEEEEEEEEEEEE EEEEEEEM
MEMMMMMMMMMMMMEM EEEEEEEEEEEEEEEEEEEEEEEEM
MEEEEEEEEEEEEEEMEEEEEEEEEEEEEEEEEEEEEEEEEM
MMMMMMMMMMMMMMMMMMMMMMMMMMMMMMMMMMMMMMMMMM
200
