1
1
8
4
67
MMMMMMMMMMMMMMMMMMMMMMMMMMMMMMMMMMMMMMMMMM
MEEEDEEEEEEEEEEMEEEEEMFEEEEEEEEEEEEFEEEEEM
MFEEEEEEEEFEEEEF EEEEMFEEEEEDEEEEEFEEEEEEM
MFEEEEEEEFEEEEEF EEEEMFFEEEEEDDEEEEEEEDEEM
MFMMMMEEFFEEDEEF EEDEMDDDEEEEFEEEEEEEEDEEM
MFDDEMEEDEEEEEEF EEEEMMMMMMEEEFEEEDEEEDEEM
MDEEEMEEEEEEEEEF EEEEEEDDEMEEEFFEFEEEEEEEM
MEEREMEEEEEDEEEM DEEEEDEEEMMMMMMEEEEEFEEEM
MEDEEMEEEEDEEEEM EEEEEEEEEEEEEEMEEEEFFEDEM
MMMMMMMMMMMMMMMM EEEEEEEEFEEEEEMMMMMMFEEEM
MEEEEEEEEEEEEEEM EEDEEEEFEEEDEEEEEEEMFEEDM
MEEEEDFDFDEEEEEM EEEDEEFEEEDEEEEEEEEMEMEEM
MEEEDFDFDEEEEEEM EEEEEEEEEEEEEEEEEEEM MEEM
MEEDFDFDEEEEEE F EEEEFFFFFFEEEEEE   M MEEM
MEDFDFDEEEEEED MMMMMMMFFFFMMMMMMMMM M MEEM
MEFDFDEEEEEEEE MDFEEEEEDEE  EEDEEEM M MEEM
MEDFDEEEEEDEEE MDFEEEEDEEEEEEEDEDEMFM MEDM
MEFDEEEEEDDEEE MDDDEEEEEEEEDEEEEE  FE MDDM
MEDEEEEEEEEEEE MMMMMMMMMMMMMMMMMMMMMM MMMM
MEEEEEDEEEEEE  F                         M
MMMMMMMMMMMMMMMMMMMMMMMMMMMMMMMMMMMMMMMMMM
50
