4
2
12
18
70
MMMMMMMMMMMMMMMMMMMMMMMMMMMMMMMMMMMMMMMMMM
MEDEFMEEEEEEEEEEEEEEEEEEEEEEEEEEEEDEEEEEEM
MDEFFMEEEEEEEEEEEEEEEEDEEEEEEEEEEEEEEEEEEM
MEEEDMEEEEEEEEFEEEEEEDEEEEEEEEEEEEEEEEEEEM
MEMMMMEEEDDEEEFEEEEEEEEEEEEEEEEEEEEEEEEDEM
MMEEEEEEEEEEEFFEEEEEEEEEEEEEEEEEEEEEEEEEEM
MEEEEEEEEEEEEFFFEEEEEEEEEEEDDDEDDDDDEEEEEM
MEEEDEEEEEEEEFDMMMMEEEEEEEEEDEEDEDEDEEEEEM
MEEDEEEEEEEDDDMFFEMEEEEEEEEEDEEDEEEDEEEEEM
MEEEEEEEEEEEFFMFFFMEEEEEEEEEEEEEEEEEEEEEEM
MEEEEEEDEEEEEFMFDFMMMMMEEEEEEEFEEEEEEEEEEM
MEEEEEEEEEEEEEMDDREEEEMEEEEEEEFMEEEEEEEEEM
MEEEEEEEEEEEEEMMMMMMMEMEEEEEEEFMMEEEEEEEEM
MEEEDDDEEEDEEEEEEEEEMEMEEEEEEEFDMMEEEEEEEM
MEEDEEEDEEDEEEEEEEEEMEMEEEEEEEFFFFFEEEEEEM
MEEDEEEDEEDEEEEEEEDEMEMEEEEEEEEEEEEEEEFEEM
MEEDEEEDEEDEEEEEEEEEMEMEEEEEEEEEEEEEEFFDEM
MEEDEEDDEEDEEEEEEEEEMEMEEEEEEEEEEEEEFFFDEM
MEEEDDDDEEDDDDEEEEEEMEMMMMEEEEEDEEEEFDDDEM
MEEEEEEEDEEEEEEEEEEM FEDDEMEEEEEEEEEEEEEEM
MMMMMMMMMMMMMMMMMMMMMMMMMMMMMMMMMMMMMMMMMM
0
